20
0 0 0 0 0 0 0 0 0 0 0 0 0 0 0 0 0 0 0 0
0 0 0 0 0 0 0 0 0 0 0 0 0 0 0 0 0 0 0 0
0 0 0 0 0 0 0 0 5 5 5 5 5 5 5 5 5 5 0 0
0 0 0 1 0 0 0 0 0 0 0 5 5 5 0 0 0 0 0 0
0 0 0 0 0 0 0 0 0 0 0 0 0 0 0 0 0 0 0 0
27 28 0 0 0 0 0 0 0 0 0 0 0 0 0 0 0 0 0 0
27 27 28 0 26 27 28 0 0 97 98 27 99 100 0 0 0 0 0 0
1 2 2 2 2 8 8 8 2 2 2 2 2 3 0 0 0 0 0 0
7 8 8 8 8 8 8 8 8 8 8 8 8 9 0 0 0 0 0 0
7 8 8 8 8 8 8 8 8 8 8 8 8 9 0 0 0 0 0 0