14
0 0 0 0 0 0 0 0 0 0 0 0 0 0
0 0 0 0 0 0 0 0 0 0 0 0 0 0
0 0 0 0 0 0 0 0 54 54 54 54 54 54
0 0 0 0 0 0 0 0 0 0 0 54 54 54
0 0 0 0 0 0 16 0 0 0 0 0 54 54
0 0 0 0 0 1 9 0 0 0 0 0 0 54
0 0 0 0 0 7 8 3 0 0 0 0 0 0
1 2 2 2 2 8 8 8 2 2 2 2 2 3
7 8 8 8 8 8 8 8 8 8 8 8 8 9
7 8 8 8 8 8 8 8 8 8 8 8 8 9