20
0 0 0 0 0 0 0 0 0 0 0 0 0 0 0 0 0 0 0 0
0 0 0 0 0 0 0 0 0 0 0 0 0 0 0 0 0 0 0 0
0 0 0 0 0 0 0 0 5 5 5 5 5 5 5 5 5 5 0 0
0 0 1 0 0 0 0 0 0 0 0 5 5 5 0 0 0 0 0 0
0 0 0 0 0 0 1 0 0 0 0 0 5 5 0 0 0 0 0 0
0 0 0 0 0 1 9 0 0 0 0 0 0 5 0 0 0 0 0 0
0 0 0 0 0 7 8 3 0 0 0 0 0 0 0 0 0 0 0 0
1 2 2 2 2 8 8 8 2 2 2 2 2 3 0 0 0 0 0 0
7 8 8 8 8 8 8 8 8 8 8 8 8 9 0 0 0 0 0 0
7 8 8 8 8 8 8 8 8 8 8 8 8 9 0 0 0 0 0 0